"filename", "language", "JavaScript", "JSON", "JSON with Comments", "TypeScript JSX", "comment", "blank", "total"
"c:\Users\alinb\FitnessAndNutrition\App.tsx", "TypeScript JSX", 0, 0, 0, 11, 0, 3, 14
"c:\Users\alinb\FitnessAndNutrition\app.json", "JSON", 0, 27, 0, 0, 0, 1, 28
"c:\Users\alinb\FitnessAndNutrition\babel.config.js", "JavaScript", 6, 0, 0, 0, 0, 1, 7
"c:\Users\alinb\FitnessAndNutrition\components\CustomInput\CustomInput.js", "JavaScript", 37, 0, 0, 0, 0, 7, 44
"c:\Users\alinb\FitnessAndNutrition\components\CustomInput\index.js", "JavaScript", 1, 0, 0, 0, 0, 0, 1
"c:\Users\alinb\FitnessAndNutrition\components\DatePickerComponent\DatePickerComponent.js", "JavaScript", 49, 0, 0, 0, 0, 7, 56
"c:\Users\alinb\FitnessAndNutrition\components\DatePickerComponent\index.js", "JavaScript", 1, 0, 0, 0, 0, 0, 1
"c:\Users\alinb\FitnessAndNutrition\components\GenderButton\GenderButton.js", "JavaScript", 43, 0, 0, 0, 0, 5, 48
"c:\Users\alinb\FitnessAndNutrition\components\GenderButton\index.js", "JavaScript", 1, 0, 0, 0, 0, 0, 1
"c:\Users\alinb\FitnessAndNutrition\components\HeightSelectorComponent\HeightSelectorComponent.js", "JavaScript", 48, 0, 0, 0, 0, 6, 54
"c:\Users\alinb\FitnessAndNutrition\components\HeightSelectorComponent\index.js", "JavaScript", 1, 0, 0, 0, 0, 0, 1
"c:\Users\alinb\FitnessAndNutrition\components\InformativeComponent\InformativeComponent.js", "JavaScript", 83, 0, 0, 0, 0, 6, 89
"c:\Users\alinb\FitnessAndNutrition\components\InformativeComponent\index.js", "JavaScript", 1, 0, 0, 0, 0, 0, 1
"c:\Users\alinb\FitnessAndNutrition\components\KnowledgeComponent\KnowledgeComponent.js", "JavaScript", 115, 0, 0, 0, 0, 7, 122
"c:\Users\alinb\FitnessAndNutrition\components\KnowledgeComponent\index.js", "JavaScript", 1, 0, 0, 0, 0, 0, 1
"c:\Users\alinb\FitnessAndNutrition\components\NavigationBarComponent\NavigationBarComponent.js", "JavaScript", 39, 0, 0, 0, 0, 6, 45
"c:\Users\alinb\FitnessAndNutrition\components\NavigationBarComponent\index.js", "JavaScript", 1, 0, 0, 0, 0, 0, 1
"c:\Users\alinb\FitnessAndNutrition\components\RoundImage\RoundImage.js", "JavaScript", 25, 0, 0, 0, 0, 4, 29
"c:\Users\alinb\FitnessAndNutrition\components\RoundImage\index.js", "JavaScript", 1, 0, 0, 0, 0, 0, 1
"c:\Users\alinb\FitnessAndNutrition\components\customButton\customButton.js", "JavaScript", 37, 0, 0, 0, 0, 11, 48
"c:\Users\alinb\FitnessAndNutrition\components\customButton\index.js", "JavaScript", 1, 0, 0, 0, 0, 1, 2
"c:\Users\alinb\FitnessAndNutrition\components\weightSelectorComponent\WeightSelectorComponent.js", "JavaScript", 48, 0, 0, 0, 0, 6, 54
"c:\Users\alinb\FitnessAndNutrition\components\weightSelectorComponent\index.js", "JavaScript", 1, 0, 0, 0, 0, 0, 1
"c:\Users\alinb\FitnessAndNutrition\contents\EducativeContent.js", "JavaScript", 59, 0, 0, 0, 0, 3, 62
"c:\Users\alinb\FitnessAndNutrition\contents\InformativeContent.js", "JavaScript", 145, 0, 0, 0, 0, 57, 202
"c:\Users\alinb\FitnessAndNutrition\package-lock.json", "JSON", 0, 14289, 0, 0, 0, 1, 14290
"c:\Users\alinb\FitnessAndNutrition\package.json", "JSON", 0, 38, 0, 0, 0, 1, 39
"c:\Users\alinb\FitnessAndNutrition\screens\ActivityScreen\ActivityScreen.js", "JavaScript", 130, 0, 0, 0, 0, 10, 140
"c:\Users\alinb\FitnessAndNutrition\screens\ActivityScreen\index.js", "JavaScript", 1, 0, 0, 0, 0, 0, 1
"c:\Users\alinb\FitnessAndNutrition\screens\CalorieScreen\CalorieScreen.js", "JavaScript", 22, 0, 0, 0, 0, 4, 26
"c:\Users\alinb\FitnessAndNutrition\screens\CalorieScreen\index.js", "JavaScript", 1, 0, 0, 0, 0, 0, 1
"c:\Users\alinb\FitnessAndNutrition\screens\EducativeScreen\EducativeScreen.js", "JavaScript", 26, 0, 0, 0, 0, 6, 32
"c:\Users\alinb\FitnessAndNutrition\screens\EducativeScreen\index.js", "JavaScript", 1, 0, 0, 0, 0, 0, 1
"c:\Users\alinb\FitnessAndNutrition\screens\FitnessScreen\FitnessScreen.js", "JavaScript", 22, 0, 0, 0, 0, 4, 26
"c:\Users\alinb\FitnessAndNutrition\screens\FitnessScreen\index.js", "JavaScript", 1, 0, 0, 0, 0, 0, 1
"c:\Users\alinb\FitnessAndNutrition\screens\GoalScreen\GoalScreen.js", "JavaScript", 102, 0, 0, 0, 0, 9, 111
"c:\Users\alinb\FitnessAndNutrition\screens\GoalScreen\index.js", "JavaScript", 1, 0, 0, 0, 0, 0, 1
"c:\Users\alinb\FitnessAndNutrition\screens\GoalTimeScreen\GoalTimeScreen.js", "JavaScript", 108, 0, 0, 0, 0, 12, 120
"c:\Users\alinb\FitnessAndNutrition\screens\GoalTimeScreen\index.js", "JavaScript", 1, 0, 0, 0, 0, 0, 1
"c:\Users\alinb\FitnessAndNutrition\screens\HeightSelectorScreen\HeightSelectorScreen.js", "JavaScript", 96, 0, 0, 0, 0, 11, 107
"c:\Users\alinb\FitnessAndNutrition\screens\HeightSelectorScreen\index.js", "JavaScript", 1, 0, 0, 0, 0, 0, 1
"c:\Users\alinb\FitnessAndNutrition\screens\InformativeScreen\InformativeScreen.js", "JavaScript", 34, 0, 0, 0, 0, 5, 39
"c:\Users\alinb\FitnessAndNutrition\screens\InformativeScreen\index.js", "JavaScript", 1, 0, 0, 0, 0, 0, 1
"c:\Users\alinb\FitnessAndNutrition\screens\ProfileConfigurationScreen\ProfileConfigurationScreen.js", "JavaScript", 93, 0, 0, 0, 0, 14, 107
"c:\Users\alinb\FitnessAndNutrition\screens\ProfileConfigurationScreen\index.js", "JavaScript", 1, 0, 0, 0, 0, 0, 1
"c:\Users\alinb\FitnessAndNutrition\screens\ProfileCreationScreen\ProfileCreationScreen.js", "JavaScript", 94, 0, 0, 0, 0, 12, 106
"c:\Users\alinb\FitnessAndNutrition\screens\ProfileCreationScreen\index.js", "JavaScript", 1, 0, 0, 0, 0, 1, 2
"c:\Users\alinb\FitnessAndNutrition\screens\ProfileScreen\ProfileScreen.js", "JavaScript", 162, 0, 0, 0, 0, 17, 179
"c:\Users\alinb\FitnessAndNutrition\screens\ProfileScreen\index.js", "JavaScript", 1, 0, 0, 0, 0, 0, 1
"c:\Users\alinb\FitnessAndNutrition\screens\SignInScreen\SignInScreen.js", "JavaScript", 100, 0, 0, 0, 0, 17, 117
"c:\Users\alinb\FitnessAndNutrition\screens\SignInScreen\index.js", "JavaScript", 1, 0, 0, 0, 0, 1, 2
"c:\Users\alinb\FitnessAndNutrition\screens\SignUpScreen\SignUpScreen.js", "JavaScript", 107, 0, 0, 0, 0, 15, 122
"c:\Users\alinb\FitnessAndNutrition\screens\SignUpScreen\index.js", "JavaScript", 1, 0, 0, 0, 0, 1, 2
"c:\Users\alinb\FitnessAndNutrition\screens\WeightSelectorScreen\WeightSelectorScreen.js", "JavaScript", 96, 0, 0, 0, 0, 11, 107
"c:\Users\alinb\FitnessAndNutrition\screens\WeightSelectorScreen\index.js", "JavaScript", 1, 0, 0, 0, 0, 0, 1
"c:\Users\alinb\FitnessAndNutrition\tsconfig.json", "JSON with Comments", 0, 0, 6, 0, 0, 1, 7
"Total", "-", 1950, 14354, 6, 11, 0, 284, 16605